111111111111111111111111111111
10P0C0000000000000000000000001
1E0000000000000000000000000001
10000C000000000000000000000001
1000000000000000000C0000000001
100000000000000000000000000001
100000000000000000000000000001
100000000000000000000000000001
100000000000000000000000000001
100000000000000000000000000001
100000000000000000000000000001
100000000000000000000000000001
111111111111111111111111111111