111111111
1P00EC001
111111111
111011111
111110111
111111111