111111111
1000C0001
1E0000P01
10000C001
111111111